22/6>
>//>/>/////>/////////>
>/>////>>/>///////////
//>>//>///////>///>//>
//>/////>//>////>///>>
/>////>///////////////
/////>//>/////>///////
>>/>/////////>/>///>/>
>/>///>////>//////////
///////////////////>//
///>///>/>/>////////>/
///>////>/>////////>/>
///>>/>/>>>//>/>//////
///////>////>>/////>/>
//>/>/>////>/>>>//////
>////>////////////////
///>///>////>/>///////
///////>/>>////////>//
////////>/>///////////
>>>/>////////>///////>
//////////>>>>/////>/>
>///////>//>//>/>/////
///////>//>>///////>//
